11111111111111111111
11111111111111111111
11111111111111111111
11ggg11111111..jjj11
11ggg1........1jjj11
11ggg1........1jjj11
11ggg1........1jjj11
11ggg1........1jjj11
11ggg1........1jjj11
11ggg1........1jjj11
11ggg1........1jjj11
11ggg..11111111jjj11
11111111111111111111
11111111111111111111
11111111111111111111
