>>>>>>>>>>>>>>>>Level 01<<<<<<<<<<<<<<<<<
-----------------------------------------
-1-1-1-1-1-1-1-1-1-1-1-1-1-1-1-1-1-1-1-1-
-----------------------------------------
-1-1-1-1-1-1-1-1-1-1-1-1-1-1-1-1-1-1-1-1-
-----------------------------------------
-1-1-1-1-1-1-1-1-1-1-1-1-1-1-1-1-1-1-1-1-
-----------------------------------------
-1-1-1-1-1-1-1-1-1-1-1-1-1-1-1-1-1-1-1-1-
-----*-*-*-----------------*-*-*-*-*-----
-1-1*g-g-g*1-1-1-1-1-1-1-1*.-.-j-j-j*1-1-
-------------*-*-*-*-*-*-*---*-----------
-1-1*g-g-g*1*.-.-.-.-.-.-.-.*1*j-j-j*1-1-
-----------------------------------------
-1-1*g-g-g*1*.-.-.-.-.-.-.-.*1*j-j-j*1-1-
-----------------------------------------
-1-1*g-s-g*1*.-.-.-.-.-.-.-.*1*j-j-j*1-1-
-----------------------------------------
-1-1*g-g-g*1*.-.-.-.-.-.-.-.*1*j-j-j*1-1-
-----------------------------------------
-1-1*g-g-g*1*.-.-.-.-.-.-.-.*1*j-j-j*1-1-
-----------*---*-*-*-*-*-*-*-------------
-1-1*g-g-g---.*1-1-1-1-1-1-1-1*j-j-j*1-1-
-----*-*-*-*-*-----------------*-*-*-----
-1-1-1-1-1-1-1-1-1-1-1-1-1-1-1-1-1-1-1-1-
-----------------------------------------
-1-1-1-1-1-1-1-1-1-1-1-1-1-1-1-1-1-1-1-1-
-----------------------------------------
-1-1-1-1-1-1-1-1-1-1-1-1-1-1-1-1-1-1-1-1-
-----------------------------------------
-1-1-1-1-1-1-1-1-1-1-1-1-1-1-1-1-1-1-1-1-
-----------------------------------------

>>>>>>>>>>>>>>>>Level 02<<<<<<<<<<<<<<<<<
-----------------------------------------
-1-1-1-1-1-1-1-1-1-1-1-1-1-1-1-1-1-1-1-1-
-----------------------------------------
-1-1-1-1-1-1-1-1-1-1-1-1-1-1-1-1-1-1-1-1-
-----------------------------------------
-1-1-1-1-1-1-1-1-1-1-1-1-1-1-1-1-1-1-1-1-
-----------------------------------------
-1-1-1-1-1-1-1-1-1-1-1-1-1-1-1-1-1-1-1-1-
-----------------------------------------
-1-1-1-1-1-1-1-1-1-1-1-1-1-1-1-1-1-1-1-1-
-----------------------------------------
-1-1-1-1-1-1-1-1-1-1-1-1-1-1-1-1-1-1-1-1-
-----------------------------------------
-1-1-1-1-1-1-1-1-1-1-1-1-1-1-1-1-1-1-1-1-
-----------------------------------------
-1-1-1-1-1-1-1-1-1-1-1-1-1-1-1-1-1-1-1-1-
-----------------------------------------
-1-1-1-1-1-1-1-1-1-1-1-1-1-1-1-1-1-1-1-1-
-----------------------------------------
-1-1-1-1-1-1-1-1-1-1-1-1-1-1-1-1-1-1-1-1-
-----------------------------------------
-1-1-1-1-1-1-1-1-1-1-1-1-1-1-1-1-1-1-1-1-
-----------------------------------------
-1-1-1-1-1-1-1-1-1-1-1-1-1-1-1-1-1-1-1-1-
-----------------------------------------
-1-1-1-1-1-1-1-1-1-1-1-1-1-1-1-1-1-1-1-1-
-----------------------------------------
-1-1-1-1-1-1-1-1-1-1-1-1-1-1-1-1-1-1-1-1-
-----------------------------------------
-1-1-1-1-1-1-1-1-1-1-1-1-1-1-1-1-1-1-1-1-
-----------------------------------------

>>>>>>>>>>>>>>>>Level 03<<<<<<<<<<<<<<<<<
-----------------------------------------
-1-1-1-1-1-1-1-1-1-1-1-1-1-1-1-1-1-1-1-1-
-----------------------------------------
-1-1-1-1-1-1-1-1-1-1-1-1-1-1-1-1-1-1-1-1-
-----------------------------------------
-1-1-1-1-1-1-1-1-1-1-1-1-1-1-1-1-1-1-1-1-
-----------------------------------------
-1-1-1-1-1-1-1-1-1-1-1-1-1-1-1-1-1-1-1-1-
-----*-*-*-----------------*-*-*-*-*-----
-1-1*g-g-g*1-1-1-1-1-1-1-1*.-.-j-j-j*1-1-
-------------*-*-*-*-*-*-*---*-----------
-1-1*g-g-g*1*.-.-.-.-.-.-.-.*1*j-j-j*1-1-
-----------------------------------------
-1-1*g-g-g*1*.-.-.-.-.-.-.-.*1*j-j-j*1-1-
-----------------------------------------
-1-1*g-g-g*1*.-.-.-.-.-.-.-.*1*j-j-j*1-1-
-----------------------------------------
-1-1*g-g-g*1*.-.-.-.-.-.-.-.*1*j-j-j*1-1-
-----------------------------------------
-1-1*g-g-g*1*.-.-.-.-.-.-.-.*1*j-j-j*1-1-
-----------*---*-*-*-*-*-*-*-------------
-1-1*g-g-g---.*1-1-1-1-1-1-1-1*j-j-j*1-1-
-----*-*-*-*-*-----------------*-*-*-----
-1-1-1-.-1-1-1-1-1-1-1-1-1-1-1-1-.-1-1-1-
-----------------------------------------
-1-1-1-.-.-.-.-.-.-.-.-.-.-.-.-.-.-1-1-1-
-----------------------------------------
-1-1-1-1-1-1-1-1-1-1-1-1-1-1-1-1-1-1-1-1-
-----------------------------------------
-1-1-1-1-1-1-1-1-1-1-1-1-1-1-1-1-1-1-1-1-
-----------------------------------------